0000000000000000
0000000000000000
0000000000000000
0000000000?00000
000000000X000000
000XXX000X000000
000X??00??000000
0000?XXXXX000000
000000????000000
000X?XX?XX?XXXX0
00000000XX???0??
000000000X?X0000
00000000000XX000
000000000000X?00
0000000000000?00
0000000000000000
