0000000000000000
0000000000000000
00X0000X00000000
0XX000XX00000000
0XX000X000000000
00X00XX000???000
00X00X00??000?00
00XXXXXX000000?0
0X00000000??00?0
0X00XXX00?0?00?0
00X0X0X00?0?00?0
00XX00X0?00?0?00
000000XX000??000
000000X000000000
0000000000000000
0000000000000000
