0000000?00000000
000000X0?0000000
000000X0X0000000
0000000?00000000
000000X0X0000000
000000X0XX000000
000000X0X0000000
000000X0X0000000
000000X0X0000000
000000X0X0000000
000000X0X0000000
000000X0X0000000
000000X0X0000000
000000X0?0000000
00XXXXXXXXXXX000
0000XXXXXXX00000
