0000000000000000
0000000000000000
0000000000000000
0000000000000XX0
0000X???0???XXX0
000?0000?0??0X00
000X00000?000X00
000X000000000X00
0000X0000000X000
000XX0000000X000
XXX00?00000?0000
0X0000?000?00000
0000000?0?000000
00000000?0000000
0000000000000000
0000000000000000
