0000000000000000
0000000000000000
00XX00000000XX00
0X0X00000000?0?0
000X??????X?X000
000?0?0?0?00X000
00X00X0X0X00X000
00X00X0X0X00X000
00X00X0X0X00X000
00X00X0X0X00X000
00X00X0X0X00X000
000?0?0?0?0??000
000??X0X0XXX0000
0000?XXXXXX00000
000000XXX0000000
0000000000000000
