0000000000000000
0000000000000000
0000000000000000
0000000000000000
0000000000000000
000000000X000000
00000000XXX00000
0X00000000000000
0XX0000XXXX00000
00XXXXX0000X0??X
000?00000000?00X
0000X0000000X00X
00000X000000X?0X
000000XXXXXX00XX
0000000000000000
00000XXXXXXXX000
