000000000000X000
000000XXX00000X0
00000X000X000000
0000X00000X00000
0000X00000X00X00
00000X0000X00000
00????X000X?0000
0?000??XXX00??00
0000?00?00?000?0
000?00?0000?00?0
000?000?000?00?0
000?0000?00?000?
0000?000?00?0000
000?000?0000?000
00?000?000000000
00?0000000000000
