0000000000000000
0000000000000000
0000000000000000
0000000000000000
0000000000000000
0000000000000000
0000000000000000
X?XXXXXXXXXX?XXX
0000000000000000
0000000000000000
X?00000000000000
X0X0000000000000
X00X000XXXXX?XXX
0?00X0XX000000XX
00?0XXX000000XXX
000??00000000XXX
