0000000000000000
0000000000000000
0000000000000000
000XXX0000000000
000X0X0000000000
000XXX000XX00000
00000??0?0000000
000000?X00000000
00000X0X00000X00
0000X000?0000X00
0000?0000X00X000
000000000X00X000
0000000000XXX000
000000000XXX0000
00000X?XX0000000
0000000000000000
