0000000000000000
00000000?0000000
00000000?0000000
000XXXXX?XXXX000
00000000000X0000
0000000000000000
0000000000000000
0000000000000000
0000000000000000
0000000000000000
00?00000000000?0
00??0000000000?0
0X??XXXXXXXXX??0
XX??XXXXXXXXX?00
0000000000000000
0000000000000000
