0000000000000000
00000000X0000000
00000000X0000000
000?00??XXX00X00
0000??00X00XX000
0000XX00X00XX000
000X00X0X0X00X00
000X000?XX000X00
0XXXXXX?XXXXXXXX
000?000?XX000X00
000?00?0X0X00X00
0000?X00X00XX000
0000??00X00XX000
000?00??XXX00X00
00000000X0000000
00000000X0000000
