000000000XXXXXXX
0000XX00XXXX0000
0000XX0XXXX0000?
00XXXXX0XX0000?0
00000XX00XX00?00
00000XX000X??000
00000XX0000??000
00000XX00000??00
00000XX000000??0
00000XX0000000??
00000XX000000000
00000XX000000000
00000XX000000000
XXX00XX000000000
XXXXXXXXXXX???X?
0000000000000000
