0000000000000000
000000XXXX000000
0000X?X00X?X0000
000???00000XX000
000XXXXXX000X000
00XXXXXXXX00XX00
00XXXXXXXX00XX00
00XXXXXXXX00XX00
00XXXXXXXX00XX00
000XXXXXX000X000
000XXX00000XX000
0000XXX00???0000
000000XX??000000
0000000000000000
0000000000000000
0000000000000000
