0000000000000000
000XXX00X0000000
000X00XXXX000000
0000XX00X0000000
000X00XXX0XXX000
00X00000X0X00X00
00X00000000000X0
0?000000000000?0
0?000000000000?0
0?000000000000?0
00?0000000000?00
00?0000000000?00
000?00000000?000
0000?0000000?000
00000???????0000