0000000000000000
0000000000000000
00000XXX??000000
0000X00000X00000
000X000X?X0X0000
00X0000???00X000
00X00000X000X000
00X000000000X000
00X000000000X000
00X000000000X000
00X000000000X000
000X0000000X0000
0000X00000X00000
00000XX???000000
0000000000000000
0000000000000000
