0000000000000000
000000XXXXX00000
00000X00000X0000
0000?000000?0000
0000X000000X0000
000X00000000X000
000X00000000X000
000X00000000X000
00XXXXXXXXXXXX00
00X00000000XXX00
00X000000XXXXX00
00X000000XXXXX00
00X000000XXXXX00
00X000000XXXXX00
000XXXXXXXXXX000
0000000000000000
