0000000000000000
0000000000000000
0000000000000000
000000XXXXXX0000
00000X000000X000
00000?000000X000
00000X000X000X00
000000?000000?00
000000?00000X000
0000000XXXXX0000
00000000X0000000
00000000X0000000
00000000X0000000
0000000XX0000000
00000000X0000000
00000000X0000000
