0000000000000000
0000000000000000
0000000000000000
0000000000000000
0000000000000000
000000X00000X000
00000X0X000X0X00
0000X000X0X000X0
000X00000X0000X0
000X0000000000X0
0000???XXXXXXX00
0000000000000000
0000000000000000
00000?00?00X0000
0000000000000000
0000000000000000
