0000000000000000
0000XXXXX?XX0000
000X000XX?XXX000
000X0000X?XXX000
000X0000X?XXX000
00XXXXXXX?XXXX00
00?000000?????00
00?000000?????00
00?000000?0???00
00?000000?????00
00X000000?XXXX00
000?XXXXX?XXX000
000?0000X?XXX000
0000XXXXX?XX0000
0000000000000000
0000000000000000
