0000X00?X000X000
00000000X0000000
0000000000000000
0000000000000000
00000?0?00000000
00000000X00?000X
00000000000?000X
0000000???0000X0
00000?X000?XX?00
0000X0000X000?00
0000?0000?00X000
00XX000000000XX0
0?0000000000000X
XXXXXXX?XX?XXXXX
XXXXXXX?XX?XXXXX
0000000000000000
