0000000000000000
0000000000000000
0000000000000000
0000000???000000
000000?000?00000
00000?00000?0000
000??00?0?00??00
00?000?000?000?0
0000000XXX000000
0000000X0X000000
0000000XXX000000
00000000X0000000
0000000XXX000000
0000000X0X000000
0000000XXX000000
0000000XXX000000
