0000000000000XX0
0000000000000XX0
0000000000000XX0
000000000000??X0
000000000000??X0
00000000000??0?0
00000000000??0?0
0000000000???0?0
000000000???0?00
00000000???0??00
0000000???0???00
000000???0???000
000????00???0000
0XX????????00000
0XX?????00000000
0000000000000000
