0000000000000000
0000000000000000
00000000X?000000
00000000X?000000
00000X?X00X?0??0
000000?XX?X0XXX0
00???0?XX?X0XX00
0X0XXX0XX?0???00
00????0??0???000
0XXXXX?XX??XXX00
00?0000000000?00
000?00000000?000
0000?000000?0000
00000??XX??00000
0000000000000000
0000000000000000
