000000XXXX000000
??0000?00X?000XX
0?0000X?00??000?
0X00000??0XX0000
XX00000000XX0000
X00000000XXX000?
00000000?XX00000
0?000000?X000000
00000000?0000000
0000000000000000
00000000??000000
0000000000000000
0000000000000000
0000000000000000
0000000000000000
0000000000000000
