0000000000000000
0XXXXXXXXXX?X?X0
0X000000000000?0
0X000000000000X0
0X000000000000X0
0?000000000000?0
00?0000000000?00
000?00000000?000
0000?000000?0000
00000?XXXX?00000
0000000XX0000000
000000X00X000000
000000X00X000000
0000000XX0000000
00X?X?XXXX?XX?00
0000000000000000
