0000000000000000
0000000000000000
0000000000000000
00?XXXXXXX?XXXXX
00?0000000000000
00X0000000000000
00X000000000XXX0
00X00000000XX00X
00X00000000XX000
00?00000000??000
XXX?0000000??000
0000???0000XX000
0000000???0XX000
0000000000?XXX00
00000000000000XX
0000000000000000
